XXXXXXXXXXXXXXXXXXXXXXXX
X          X           X
X          X           X
X    T     XX  U       X
X           X          X
X       R   X          X
X           X          X
X    XXXXX####XXXXX    X
X                      X
X           E          X
X                      X
X    XXXXX####XXXXX    X
X          X           X
X          X           X
X  P       X           X
X          XX       T  X
X           X  U       X
X           X          X
XXXXXXXXXXXXXXXXXXXXXXXX
