XXXXXXXXXXXXXXXXXXXXXXXX
X                      X
X        Y           T X
X                      X
X   XX##XX##XX##XX##   X
X                      X
X                      X
X                      X
X                      X
XP  ##XX##XX##XX##XX  TX
X                      X
X            Y         X
X                      X
X                      X
X   XX##XX##XX##XX##   X
X                      X
X     Y              T X
X                      X
XXXXXXXXXXXXXXXXXXXXXXXX
