XXXXXXXXXXXXXXXXXXXXXXXX
X        X             X
X        X             X
X   E    X             X
X        X    X        X
X        X    X      E X
X        #    #        X
X    XXX##    ##XXXXXXXX
X                      X
X          E           X
X                    E X
XXXXXXXX##    ##XXX    X
X        #    #        X
X        X    X        X
X  P     X    X        X
X             X        X
X             X     E  X
X             X        X
XXXXXXXXXXXXXXXXXXXXXXXX
