XXXXXXXXXXXXXXXXXXXXXXXX
X                      X
X         U          E X
X                      X
X   X   #X#X#X#XX      X
X   X           X      X
X   X           X      X
X   X           XX#X   X
X   X              X   X
X   X         U    X   X
X   X              X   X
X   X#XX           X   X
X      X E         X U X
X      X           X   X
X      XX#X#X#X#   X   X
X                      X
X P                    X
X                      X
XXXXXXXXXXXXXXXXXXXXXXXX
