XXXXXXXXXXXXXXXXXXXXXXXX
X                      X
X                      X
X                   U  X
X    X#X#X    X        X
X    X        X        X
X    X U      X        X
X    X        X#X#X    X
X                      X
X                      X
X                      X
X    X#X#X        X    X
X        X        X    X
X        X        X    X
X        X    X#X#X    X
X   P                  X
X                   U  X
X                      X
XXXXXXXXXXXXXXXXXXXXXXXX
