XXXXXXXXXXXXXXXXXXXXXXXX
X                      X
X                      X
X                      X
X     X     X          X
X     X     X          X
X           #          X
X  P        #       B  X
X     X     X          X
X     X     X          X
X                      X
X                      X
X                      X
XXXXXXXXXXXXXXXXXXXXXXXX
X                      X
X                      X
X                      X
X                      X
XXXXXXXXXXXXXXXXXXXXXXXX
