XXXXXXXXXXXXXXXXXXXXXXXX
X                      X
X               R    E X
X                      X
X   XXXXXXXXXOXOXOX#X#XX
X   X                  X
X   X                  X
X   X  E               X
X R X          XXXXX   X
X   X              X   X
X   XXXXX          X   X
X               E  X   X
X                  X R X
X                  X   X
XX#X#XOXOXOXXXXXXXXX   X
X                      X
X P                    X
X                      X
XXXXXXXXXXXXXXXXXXXXXXXX
