XXXXXXXXXXXXXXXXXXXXXXXX
X                      X
X U      U        U    X
X                      X
XX##XX##XX##XX##XX##   X
X                      X
X         U            X
X                   U  X
X                      X
X   ##XX##XX##XX##XX##XX
X                      X
X                      X
X                    U X
X                      X
XX##XX##XX##XX##XX##   X
X                      X
X P               U    X
X                      X
XXXXXXXXXXXXXXXXXXXXXXXX
