XXXXXXXXXXXXXXXXXXXXXXXX
X                      X
X                      X
X                      X
X                      X
X                  # L X
X                  X#  X
X                      X
X                      X
X                      X
X                      X
X                    L X
X  #X                  X
X   #                  X
X  P                   X
X                      X
X                      X
X                      X
XXXXXXXXXXXXXXXXXXXXXXXX
