XXXXXXXXXXXXXXXXXXXXXXXX
X               OOO    X
X               OOO    X
X               OOO    X
X  U        #        E X
X           #          X
X               OOO    X
X       T       OOO    X
X               OOO    X
XXXXXXXXXXXXXXXXXXX    X
X               OOO    X
X               OOO    X
X               OOO    X
X           #     T    X
X  P        #          X
X               OOO E  X
X               OOO    X
X               OOO    X
XXXXXXXXXXXXXXXXXXXXXXXX
