XXXXXXXXXXXXXXXXXXXXXXXX
X                      X
X L                  U X
X                      X
X   XXXXOXXXXOXXXXXX   X
X   X              X   X
X                      X
X                      X
X                      X
X           E          X
X                      X
X                      X
X                      X
X   X              X   X
X   XXXXXXOXXXXOXXXX   X
X                      X
X P                 L  X
X                      X
XXXXXXXXXXXXXXXXXXXXXXXX
