XXXXXXXXXXXXXXXXXXXXXXXX
X                      X
X                    U X
X                      X
X   XXXXXXX  XXXXXXX   X
X   X              X   X
X Y X              X   X
X   #              #   X
X   #              #   X
X   # P   ####  U  #   X
X   #              #   X
X   #              # E X
X   X              X   X
X Y X              X   X
X   XXXXXXX  XXXXXXX   X
X                      X
X                   U  X
X                      X
XXXXXXXXXXXXXXXXXXXXXXXX
