XXXXXXXXXXXXXXXXXXXXXXXX
X                      X
X                      X
X                      X
X                   G  X
X                      X
X    XXXXXXXX####      X
X                      X
X                      X
X                      X
X                      X
X                      X
X       ####XXXXXXXX   X
X                      X
X  P                   X
X                      X
X                      X
X                      X
XXXXXXXXXXXXXXXXXXXXXXXX
