XXXXXXXXXXXXXXXXXXXXXXXX
X                      X
X                      X
X                   T  X
X     XX#X#X#X#X#X     X
X     X          X     X
X     X                X
X     X                X
X     X                X
X  P  X  E             X
X     X                X
X     X                X
X     X     G          X
X     X          X     X
X     XX#X#X#X#X#X     X
X                      X
X                  R   X
X                      X
XXXXXXXXXXXXXXXXXXXXXXXX
