XXXXXXXXXXXXXXXXXXXXXXXX
X                      X
X                      X
X  E        U       Y  X
X       E              X
X  OO  OO  OO  OO  OO  X
X  OO  OO  OO  OO  OO  X
X                      X
X                      X
X                      X
X                      X
X    G                 X
X  XX  XX  XX  XX  XX  X
X  XX  XX  XX  XX  XX  X
X                      X
X                      X
X          P           X
X                      X
XXXXXXXXXXXXXXXXXXXXXXXX
