XXXXXXXXXXXXXXXXXXXXXXXX
X                      X
X     G                X
X                      X
X   XX######X          X
X           X          X
X           X          X
X           X          X
X           X          X
X  P       XX       B  X
X          X           X
X          X           X
X          X           X
X          X           X
X          X######XX   X
X                      X
X                  G   X
X                      X
XXXXXXXXXXXXXXXXXXXXXXXX
