XXXXXXXXXXXXXXXXXXXXXXXX
X                      X
X              L       X
X         B        L   X
X     X     X          X
X     X     X          X
X           #          X
X  P        #       E  X
X     X     X    U     X
X     X     X          X
X        B             X
X             L   L    X
X                      X
XXXXXXXXXXXXXXXXXXXXXXXX
X        X    X        X
X                      X
X                      X
X                      X
XXXXXXXXXXXXXXXXXXXXXXXX
