XXXXXXXXXXXXXXXXXXXXXXXX
X                      X
X              T       X
X                      X
X                      X
X                  #   X
X                  X#  X
X                      X
X                      X
X                      X
X                      X
X                    T X
X  #X                  X
X   #                  X
X  P                   X
X                      X
X                      X
X                      X
XXXXXXXXXXXXXXXXXXXXXXXX
