XXXXXXXXXXXXXXXXXXXXXXXX
X                      X
X                      X
X                      X
X    X#X#X#XXXXXXXX    X
X          O      G    X
X          O           X
X          O           X
X          O           X
X  P       OO       T  X
X           O          X
X           O          X
X           O          X
X           O          X
X    XXXXXXXX#X#X#X  T X
X                      X
X                 G    X
X                      X
XXXXXXXXXXXXXXXXXXXXXXXX
