XXXXXXXXXXXXXXXXXXXXXXXX
X                      X
X       G              X
X                      X
X   Y      XX       G  X
X          #           X
X          #  G        X
X          #           X
X          #           X
XXXXXXXX   ##   XXXXXXXX
X           #          X
X           #          X
X           #          X
X           #          X
X  P       XX       Y  X
X                      X
X              G       X
X                      X
XXXXXXXXXXXXXXXXXXXXXXXX
